5
V,V,V,V,V
V,E,E,E,V
V,E,S,V,V
V,E,E,E,E
V,V,V,V,V
E,V,E,V,E
E,V,E,V,E
E,V,E,V,E
E,V,E,V,E
E,V,E,V,E
E,V,E,V,E
E,V,E,V,E
E,V,E,V,E
E,V,E,V,E
V,V,E,V,V
E,E,E,E,E
V,V,V,V,V
E,E,E,E,E
V,V,V,V,V
E,E,E,E,E
E,E,E,E,E
V,V,V,V,E
E,E,E,V,E
V,V,V,V,E
E,E,E,E,E
V,V,V,V,V
V,E,E,E,V
V,V,Z,E,V
E,E,E,E,V
V,V,V,V,V