5
E,E,V,E,E
E,E,E,E,E
S,C,W,E,V
E,E,E,E,E
E,E,V,E,E
E,E,V,E,E
E,E,V,E,E
E,E,V,V,V
E,E,I,E,E
E,E,W,E,E
E,E,W,E,E
E,E,C,E,E
W,C,A,E,V
E,E,C,E,E
E,E,W,E,E
E,E,E,E,E
E,E,E,E,E
V,V,V,W,I
E,E,W,E,E
E,E,I,E,E
E,E,W,E,E
E,E,M,E,E
V,W,V,E,I
E,E,E,E,E
E,E,E,E,E
E,E,E,E,E
E,E,E,E,E
V,V,Z,E,E
E,E,E,E,E
E,E,E,E,E