W,0,1,2,V,0,2,0,0,2,1
W,3,0,1,V,3,1,2,3,1,1
W,3,2,2,I,3,1,0
W,4,0,0,V,4,1,2,4,1,0
W,4,0,2,V,4,2,1,4,2,0
W,5,1,2,I,5,1,1
W,5,1,0,V,5,0,0,5,0,1