W,0,1,2,M,0,2,0,0,2,1
W,3,0,1,M,3,1,2,3,1,1
W,3,2,2,I,3,1,0
W,4,0,0,M,4,1,2,4,1,0
W,4,0,2,M,4,2,1,4,2,0
W,5,1,2,I,5,1,1
W,5,1,0,M,5,0,0,5,0,1