W,4,0,0,V,4,1,1,4,0,1
W,0,2,2,V,4,0,1,4,1,1
W,4,0,2,V,4,1,1,4,1,2
W,5,2,0,V,4,1,2,4,1,1
W,4,2,2,V,4,1,1,4,2,1
W,1,1,1,V,4,2,1,4,1,1
W,4,2,0,V,4,1,1,4,1,0
W,2,1,0,I,0,2,1
W,2,0,2,W,2,2,2,2,1,2
W,2,2,2,V,2,0,1,2,1,1