W,4,0,0,I,0,2,3
W,4,1,2,I,0,3,2
W,1,3,3,I,4,0,1
O,2,2,0,2,2,3,3,3,2
O,2,1,0,2,1,3,2,3,3
W,1,0,3,I,1,1,2
W,1,1,3,I,1,2,2
T,4,2,0,I,4,2,1
W,0,2,2,C,0,3,1
W,0,0,0,C,3,2,2
W,0,1,1,C,0,0,2
W,5,3,2,C,5,0,2
W,5,3,0,C,5,2,0
W,5,3,3,C,5,2,3