W,4,0,2,M,4,1,2,4,2,3
W,4,2,1,I,4,2,4
W,3,3,2,I,3,4,2
W,3,2,3,I,3,2,4
W,0,2,2,C,0,2,1
W,2,0,2,C,2,1,2
W,2,4,2,C,2,3,2
W,2,2,0,C,2,2,1
W,1,4,2,C,1,3,2